XXXXXXXXXXXXXXXXXX
XXXD XX D   XXXXXX
XDXX X  XX  XXXXXX
X    X  XX  DXXXXX
X                X
XXXXXXDXXXXXXXXXXX
XXXXXXXXXXXXXXXXXX
